Tl8se3kt6A	Default
daDaiVCiyb	Accountants
FmQOOOnsLt	American diners
wV0KTCuNYi	Animals
n9N5VsofBj	Antiques
HGvOTAh8so	Art Shops
yvigrBgoVZ	Awnings
rFzH582wCq	Baby Products
N18dv8hCwe	Barristers
pGEsVEnb5r	Bars
aYkmERf4CW	Bathroom Design
EdPZHP9irm	Bathroom Installation
NwKW6XqntK	Bathrooms
GfkIrIMSLU	Beauty
VD7BEUjW5A	Beauty salons
bB6keITyfT	Bedding
DzihgRCHZK	Beds
aUCHdmmsE2	Beer
lqYyCayqOl	Blinds
N0Lm6HkPoz	Board games
LSC9Axn0Ae	Boarding kennels
ICFOTqZz46	Kennels
kxlgflTX5m	Boiler repairs
cEqK8qdRRh	Boiler services
feM9oYBe3L	Books
JKTJL886ie	Bottled gas
s4VoBDoKXV	Brewing supplies
AdKt6nXVcX	Bugaboo
nbTpwYv60Y	Builders
ox2SkFx6y5	Building maintenance
aYgkPBykJ4	Building supplies
pljtISX7R4	Building merchants
TLLP71WRqT	Bureaux De Change
Sz10R6Zu7L	Burglar Alarms
wuH2uag9mf	Bus Services
faRgZNZq2j	Cable TV
HwL8FBHTtG	Cafes
XAQtTmBg5G	Cake makers
EanR1qE1Vl	Camping equipment
tfpnnv1QRg	Camping sites
DTyZcO6nfa	Car accessories
NAl6sSdZrv	Car audio systems
TjZKqjfRON	Car body repairs
Vbn9CnNZau	Car dismantlers
IPvnS91GbG	Car garages
pSfyNICFwd	Car hire
QPoBwGUzKx	Car parts
gFEBaAZ0nR	Car rental
mEEVcZGKwW	Car repair
IY0pzg7dsi	Car showrooms
lPeMflWQeR	Car storage
naelsGMEnJ	Car tyres
CJFEEW0n2W	Car valeting
Pz3jN7CKVR	Caravan Dealers
pQRN0mRrdG	Caravan parks
wjBgXajgiu	Caravan storage
iDQ9cF5maE	Care agencies
S1KNJTjh4h	Carpenters
WQvJNZDasf	Carpet Cleaners
wC2wgexEsO	Carpet Repair
Q3z0iAKxax	Carpets
n4jSUfSnbz	Cars
VT1Fk4TOSU	Cars for sale
HQf25aEeRF	Cat Grooming
jdISz9OTAq	Cemeteries
B8zmmkYS5K	Central heating boilers
g3dV4iM6rF	Central heating pumps
dBZENVnzrq	Central heating radiators
UGGZIU90NP	Central heating services
Ns4KW9iDQh	Central heating systems
w4TXqdjwNE	Charitable organisations
lRZB1ZoAyw	Childcare
Uh6QMPvwgs	Childminders
BJUdTRmr3J	Child's play
tqlPPqHiPu	Chinese restaurants
wmaf0MiT8C	Chiropodists
RcO0pqQTrd	Citizens advice
rcvWQsdxnx	Cleaners
IgYJ8bQpes	Clothing
oFQFHoYHgT	Clothing Manufacturers
rOAnwcuMOQ	Clothing Wholesalers
WOnxmhCUVr	Coach Services
L9oie8rvRB	Coffee
tfQrDmkad8	Coffee Shops
P9bzWbwUTu	Collection Services
bfDPUinSHB	Comedy
ElYfuEpVXc	Live comedy
iRY31367Ul	Commercial Estate Agents
CTNqS8uJVb	Commercial Vehicle Manufacturers
yop97y58Kv	Commercial Vehicles
m2rwXP3h3T	Computer repair
eFJ8TazpKE	Computers
BBlrD2BDWg	Condensing Boiler
SFUN1AgG6i	Consulting Engineers
kyDXqrREXo	Convenience shops
OgtSarJNvb	Conveyancing
BwEpzzE7qk	Cooker repairs
R9S0uTjas3	Cookers
tFgzYCCGBB	Cosmetics
tL8a4xMkFf	Counselling
Jl0mLkcj5p	Craft Shops
Y9tb5cG94p	Creches
j67QzcwUpO	Crockery
ioIFjgm9is	Cupboards
aclWa3LcD4	Curry
LJkgPXJY56	Curtains
DMwGCPwiEf	Cutlery
X6n75iGm0B	Cycle repairs
fkP4GppoJv	Cycle shops
Xt5Vc7Z09d	Damp proofing
k9MCXORxYb	Day nurseries
WqGtpol5Mn	Decorators
ZIzSZvzY4x	Dentists
W1ryZLdprZ	Department stores
vFPfV72ZKG	Diesel
iehJ3KEql1	DIY outlets
dNddIooSa8	Doctors
asQEZQnq2B	Dog Grooming
mAbrikE8Hl	Domestic Removals
ISVoHq8r6m	Doors
GtODlsNJbl	Double glazing
dA8KlRzbJq	Draws
KdgNdIPHdA	Driveways
mRQZ6AQAE5	Driving instructors
G8FeUXReRH	Driving lessons
AAMLJ10YQU	Driving schools
iFbRrEYqzU	Drums
eGgOQetMCG	Eating Out
oChJfpx4M0	Electrical appliances
vbazs5nBet	Electrical contractors
Kdvww6xYiT	Electrical inspection
P3GqtZttsO	Electrical installation
PzPW5V3COa	Electricians
lsrEMMcllk	Electrolysis
bRfzPFgQEV	Estate agents
S3mfuL4zTY	Family planning
OSQjrmN1Af	Fashion
RBnOJsjUyy	Guitar amps
ZWZpwbNSJH	Bass guitar amps
muq7jvPwWF	Florists
ZGq4LhvmCX	Foreign Exchange
iWzcYw9hsP	Frame makers
PR9qMwq9l6	French food
Tz5WHzwgPf	Fuel
fdQChzDtzE	Fun in the sun
NrS7FF4Ogk	Function Rooms
LXClW5noxj	Furniture outlets
nBdltrqLKV	Galleries
ESQqRKLyRR	Garage conversions
eSqsk9lypq	Garage services
rkUeajQh5c	Garages
kVn5VOjxIX	Garden buildings
A7lTtpYlf9	Garden equipment
BD7HIZlLFR	Gardeners
SXz2WY0ocf	Gas boilers
CyIsHCWGrs	Gates
RXtwJcs9bH	Golf courses
MvNR8yZSal	Golfing ranges
cqzE5qpj96	Graphic designers
tbfagdtlfo	Designers
RQm4Dlbios	Gravel suppliers
wPDDyDMfGh	Great food
ojk0Rohwd9	Grocers
iGCaltBxDg	Guitars
OWyQ2xFEov	Gun Dealers
RQcabETspA	Gunsmiths
jGau9LMOkL	Hair extensions
x5owkhSC3x	Hair salons
BWZm8hkHTW	Hairdressers
OwGTCpb3T9	HGV Training
XgfpJnDMqg	Hotels
yYkHgltbfk	Removals
mocCtpAzBx	House wares
NN1Ii80fOc	Wigs
Xqnt89LsnH	Ice rinks
MCr2Gqr1jB	Independent Colleges
uMGPRnWAOG	Independent Schools
nVi0AX4EFt	Indian restaurants
mqxe0eb4Vy	Indian food
mwvDJvFp7g	Indoor fun
WKa67pljAq	Injury Lawyers
bUR1vj5lCZ	Intensive Driving Courses
RyUzsZMWAu	Interior designers
cHE0jEwNKe	Ironing Services
h9DOk2r33c	Italian restaurants
l8JlBrFC5s	Jewellers
BL5Kn3GILN	Joiners
nrV1QrT1wQ	Jokes
LInPPCyWbj	Karting
EC6TLStkk3	Kitchen Installation
G7xIepm3SI	Kitchens
Q9kFx8OFMX	Ladies Clothes
Us6lCK9j0K	Landscapers
dUFLrbfkdK	Laptops
fC2VQMmqQy	Laser Hair Removal
wJYXkCkJqF	Laundrettes
QtLVDlWhrg	Laundry services
OyITnnOs5H	Lawnmowers
JOmNi1BEHI	Lawyers
LRFZxMZGfR	Legal Advice
uc0mmGPI77	Legal Services
ENb5GIJMuy	Letting agents
it98HqPgCD	Live music
jlYXgDbW2q	Live music venues
sbC4Y7zwVY	Locksmiths
pc2oNxJYPp	Loft Conversions
UFtJcGJkMN	Lorry hire
aVosoRZ8oW	Luxury Car hire
o7H53TWf83	Machinery hire
tLkEQlFSkQ	Magic tricks
iOuXEshIDH	Magicians
qSwsnyQXOw	Mapex drums
NITNsIHi66	Marquee hire
PPVuLeYY7a	Mobile Hairdressers
VMbEo7ldN3	Mobile Phone Accessories
ATj3AuiOG2	Mobile phones
XyUVRlV48t	MOT garage
qj0WpIXDcE	Mother and baby
jRLiUFoXB0	Mother and toddler
jV4TbFwox7	Motorcycles
u6U5FrEIir	Museums
hNKsXx7iRG	Music
bWel8CHbWS	Music festivals
nl8VkOQycd	Musical Instruments
CK0Fnch4Gu	Night clubs
hTBvFgCOj6	Outdoor equipment
QJOP3Ey2cT	Outdoor events
DGjhBz6FK0	Outdoor fun
q4KCfAixGP	Paintballing
SGk7z8TWXp	Painters
stKxiBmAhV	Party venues
TiUiKiJsh1	Party entertainers
u5rvgbEOLk	Paving
LcReU8f0Lw	Perfume
ZstBM2aAq9	Personal injury
yaAbxfaBfh	Pest control
ZRESjIpxk8	Pet supplies
SibLHgO0LL	Petrol
M2g9cuthZL	Photographers
vpdaoujjVN	Piano tuners
UUApxABKql	Pianos
Vc5QduAvRu	Picture framers
kAWOPpXfbs	Pipe cleaning
WOKZO6wpGe	Pizza delivery
kvVyM5TcOX	Pizza restaurant
v6CHuGIXYk	Pizza takeaway
LVaAupQ2D8	Plant hire
gxljsFeX9B	Plasterers
CSk6vIDukL	Plastering
V0a44rYBcG	Play centres
T8JB68Ady7	Play parks
GyzqtANjsg	Playgroups
fNDGvlD8R2	Plumbers
DbxcSx04b9	Plumbing
B52gXf9FeK	Podiatrists
JEnYV1rCgh	Pond supplies
y8NArXhjaq	Post offices
fDX92lGTLQ	Prams
ZzEK3xHPwE	Pre-school
rgvOX5xghX	Printers
ofLSOmOc4A	Property for rent
CsyjoE8Aow	Property for sale
WcMmaOWtqD	Pub Food
gsuOGbTIkz	Public Houses
nDDz8wSWaN	Publishers
BfvDyMVDPh	Pubs
WiD6Z9ybE5	Pushchairs
KSxg3SektT	Railings
WovxzCVhtX	Real Ale Pubs
N6Se7KeRJS	Record shops
idYZIMxOju	Recording studios
CgMFQyyYJa	Rehearsal rooms
dWvfgK2Lu9	Removals
IrErRQdgo5	Residential Homes
BBI1HVa7uT	Restaurants
la3rctjh2U	Retirement homes
eNVNfH1XUz	Roller skates
XVqqtTFuLa	Roofers
QIWLboktgj	Roofing Services
kZNkkhIk7T	Rugs
pMvo6UQVvx	Salons
kwxShRrsf0	Satellite TV
qRGZkEDL40	Scaffolding
UMKivW1RqZ	Schools
k7UmEaAGfV	Scooters
DB28fJugCf	Scrap yards
CIXSIUeJxr	Security services
KfXZCRX4E3	Security systems
m1FIxlPAju	Self build
O6to1I2Wh1	Self drive
gXMpjzWJPp	Sewing Machines
h099zxS6xU	Sheds
sqzAOOPqiR	Shooting ranges
BeAR3DBYbW	Shopping centres
c9XpmgEqdX	Sign makers
oTzFLht6JC	SJC drums
CEgjxPMfYP	Skate boards
MZlLcUrZoG	Skate parks
KZU5aJ33sk	Ski slopes
gSyRN9Yr2i	Skip hire
ffZTAXqVGQ	Skips
nWXnBwhvlr	Smart phones
HJbGNKcaUS	Sofas
vZKLbFw9yJ	Soft furnishings
DeTP8TlUTS	Soft play
dOqF9axx3G	Solicitor
NISODkukCB	Solicitors
GMTu1n9Xrr	Solid Fuel
XGGgRX8LJY	Storage
Vs36U1OimV	Strollers
mfNKMYIlLj	Supermarkets
uQKuAkFFta	Superstores
wHCpyTux46	Surveyors
hogD42iwk9	Swimming baths
awn07JtNQZ	Swimming pools
e5MSWc62iE	Table wear
mglMqGZjlL	Tailors
cqw65avVnH	Taxis
Sxd7PKBrP3	Tea
hn7Vv5RWy8	Tennis clubs
m1LnYQaaJG	Tennis courts
RPx2SDib7H	Thai restaurants
OZZo3VvwRb	Thai food
rpLT42CLlq	Theme parks
Z7hQjlYn8z	Things to do
tup6IowiQd	Toys
wXkMnTdY8M	Truck hire
o3TSusT9IQ	TVs
K31AZrrALf	Tyres
krNwctztwW	Uppababy
sdjiks5DUq	Used cars
AgwimrzUte	Vacuum cleaner parts
RF8RViAimC	Vacuum cleaners
eJ62vxOz2t	Valuers
x4HgAqsXxp	Van hire
jISWidOm5Y	Voluntary organisations
YQHyY7nVeE	Web design
LXjcKsztha	Web development
f3WuL4nAVG	Wedding car hire
wvRLiO25ID	Wedding dresses
hSErz0J0LW	Wet parks
bFjEXvffEF	Whiskey
JUY7lqR0WG	Window cleaners
sL3wbDFRTj	Wine merchants
jRlKfXLv1R	Petting farms
eV33eDBdqH	Waterparks
pcS8lFhmk4	Climbing centres
CHa8FWrpdX	Ten-pin bowling
lgy0KvokfE	Outdoor play
LBNKYQxNAL	Water fun
ByOeU4m5yo	History
QKHxWre5Il	Beaches
TElhx51ItH	Nature
wdiAZNYBZi	Airports
FoCqnJjcxU	Antique dealers
dHXoC9HR0L	Architectural services
wDHyha7rpa	Catteries
fvq9RdJn8m	Courier services
YBcCMO51eD	Office supplies
RULVfTJLgh	Office equipment
iAfx7m21V8	Fencing services
swx287Z8WP	Fridges
ru7LEHjpzx	Freezers
IbRREflkOb	Funeral directors
M0vFfkz2vm	Nursing homes
cpphVXwWx0	Recruitment agencies
QTxUe8EFhB	Attractions
FMAVAbJChL	Equestrian centres
XSvmfZyNT9	Activities
Z256KHCRHR	Comedians
BZqsaSInt5	Milk deliveries
vgN36mrAvO	Grocery deliveries
WzzBM3mwgB	Massage parlors
MgFsxkC2eA	Drum tuition
wQaRdas7HP	Drum tutors
l5sMAaJig5	Guitar tuition
NYGnb2ts5k	Guitar tutors
kwAreLHlYK	Piano tuition
CiIa0vMGU3	Piano tutors
x6uH5OeDh4	Music tuition
AqAJGgf8vI	Music tutors
ItUZXrptpQ	Woodwind tuition
hG6Svgkgfl	Woodwind tutors
TLw05OZima	Percussion tuition
EhS7ZVC54Q	Percussion tutors
SpWdFmzvDA	English tutors
BxnUbalCQv	Maths tutors
KMrFKoXVMm	Science tutors
ZtXQsCU41z	French language tutors
LCXSOYusUF	Language tutors
NgB5M554o2	Spanish language tutors
YK27IhpV3g	PA hire
BSOjX2nJCn	Disco hire
THXmnFf99O	Recycling centres